112 112 112 112 112 112 112 112 112 112 112 112 112 112 112 112 112 112 112 112 112 112 112 112 112 112 112 112 112 112 112 112 112 112 112 112 112 112 112 112 112 112 112 112 112 112 112 112 112 112 112 112 112 112 112 112 112 112 112 112 112 112 112 112 112 112 112 112 112 112
112 112 112 112 112 112 112 112 112 112 112 112 112 112 112 112 112 112 112 112 112 112 112 112 112 112 112 112 112 112 112 112 112 112 112 112 112 112 112 112 112 112 112 112 112 112 112 112 112 112 112 112 112 112 112 112 112 112 112 112 112 112 112 112 112 112 112 112 112 112
112 112 112 112 112 112 112 112 112 112 112 112 112 112 112 112 112 112 112 112 112 112 112 112 112 112 112 112 112 112 112 112 112 112 112 112 112 112 112 112 112 112 112 112 112 112 112 112 112 112 112 112 112 112 112 112 112 112 112 112 112 112 112 112 112 112 112 112 112 112
112 112 112 112 112 112 112 112 112 112 112 112 112 112 112 112 112 112 112 112 112 112 112 112 112 112 112 112 112 112 112 112 112 112 112 112 112 112 112 112 112 112 112 112 112 112 112 112 112 112 112 112 112 112 112 112 112 112 112 112 112 112 112 112 112 112 112 112 112 112
112 112 112 112 112 112 112 112 112 112 112 112 112 112 112 112 112 112 112 112 112 112 112 112 112 112 112 112 112 112 112 112 112 112 112 112 112 112 112 112 112 112 112 112 112 112 112 112 112 112 112 112 112 112 112 112 112 112 112 112 112 112 112 112 112 112 112 112 112 112
112 112 112 112 112 112 112 112 112 112 112 112 113 114 114 114 114 114 114 114 114 114 114 114 114 115 112 112 112 112 112 112 112 112 112 112 112 112 112 112 112 112 112 112 112 112 112 273 274 274 274 274 274 274 274 274 274 274 274 274 275 112 112 112 112 112 112 112 112 112
112 112 112 112 112 112 112 112 112 112 112 112 116 111 110 111 110 111 110 111 110 111 110 111 110 117 112 112 112 112 112 112 112 112 112 112 112 112 112 112 112 112 112 112 112 112 112 276 201 200 201 200 201 200 201 200 201 200 201 200 277 112 112 112 112 112 112 112 112 112
112 112 112 112 112 112 112 112 112 112 112 112 116 110 111 110 111 110 111 110 111 110 111 110 111 128 129 129 129 129 129 129 129 129 129 129 129 129 129 129 289 289 289 289 289 289 289 290 200 201 202 201 200 201 200 201 200 201 202 201 277 112 112 112 112 112 112 112 112 112
112 112 112 112 112 112 112 112 112 112 112 112 116 111 110 131 132 132 132 140 133 111 110 111 110 111 111 110 111 110 111 110 111 110 111 110 111 110 111 110 201 200 201 200 201 200 201 200 201 200 201 202 201 200 201 200 201 202 201 200 277 112 112 112 112 112 112 112 112 112
112 112 112 112 112 112 112 112 112 112 112 112 116 110 111 136 111 110 111 110 136 110 111 110 111 110 110 111 110 111 110 111 110 111 110 111 110 111 110 111 200 201 200 201 200 201 200 201 200 201 200 201 200 201 200 201 200 202 200 201 277 112 112 112 112 112 112 112 112 112
112 112 112 112 112 112 112 112 112 112 112 112 116 111 131 139 110 111 110 111 136 111 110 111 110 123 124 124 124 124 124 124 124 124 124 124 124 124 124 124 284 284 284 284 285 200 201 200 201 200 201 200 201 200 201 200 201 200 201 200 277 112 112 112 112 112 112 112 112 112
112 112 112 112 112 112 112 112 112 113 114 114 130 110 134 110 111 110 111 110 136 110 111 110 111 117 112 112 112 112 112 112 112 112 112 112 112 112 112 112 112 112 112 112 276 201 200 201 200 201 200 201 200 201 200 201 202 201 200 201 277 112 112 112 112 112 112 112 112 112
112 112 112 112 112 112 112 112 112 116 110 111 131 138 139 111 110 111 110 111 136 111 123 124 124 120 112 112 112 112 112 112 112 112 112 112 112 112 112 112 112 112 112 112 276 200 201 200 201 200 201 200 201 200 201 202 201 283 284 284 280 112 112 112 112 112 112 112 112 112
112 112 112 112 112 112 112 112 112 116 111 110 134 110 111 110 111 110 111 131 139 110 117 112 112 112 112 112 112 112 112 112 112 112 112 112 112 112 112 112 112 112 112 112 276 201 200 201 200 201 200 201 200 201 200 201 202 277 112 112 112 112 112 112 112 112 112 112 112 112
112 112 112 112 112 112 112 112 112 116 110 111 134 111 110 111 110 111 131 139 110 111 117 112 112 112 112 112 112 112 112 112 112 112 112 112 112 112 112 112 112 112 112 112 276 200 201 200 201 200 201 200 201 200 201 200 201 277 112 112 112 112 112 112 112 112 112 112 112 112
112 112 112 112 112 112 112 112 112 116 111 110 111 110 111 110 111 131 139 110 111 110 117 112 112 112 112 112 112 112 112 112 112 112 112 112 112 112 112 112 112 112 112 112 276 201 200 201 200 201 200 201 200 201 200 201 200 277 112 112 112 112 112 112 112 112 112 112 112 112
112 112 112 112 112 112 112 112 112 116 110 111 110 111 138 138 138 139 110 111 110 111 117 112 112 112 112 112 112 112 112 112 112 112 112 112 112 112 112 112 112 112 112 112 276 200 201 202 201 200 201 202 201 200 201 202 201 277 112 112 112 112 112 112 112 112 112 112 112 112
112 112 112 112 112 112 112 112 112 116 111 110 111 110 111 110 111 110 111 110 111 110 128 115 112 112 112 112 112 112 112 112 112 112 112 112 112 112 112 112 112 112 112 112 276 201 202 201 200 201 202 201 200 201 202 201 202 288 275 112 112 112 112 112 112 112 112 112 112 112
112 112 112 112 112 112 112 112 112 118 119 119 119 119 119 119 125 111 110 111 110 111 110 117 112 112 112 112 112 112 112 112 112 112 112 112 112 112 112 112 112 112 112 112 278 279 279 279 279 279 279 285 201 200 201 200 201 200 277 112 112 112 112 112 112 112 112 112 112 112
112 112 112 112 112 112 112 112 112 112 112 112 112 112 112 112 116 110 111 110 111 110 111 117 112 112 112 112 112 112 112 112 112 112 112 112 112 112 112 112 112 112 112 112 112 112 112 112 112 112 112 276 200 201 200 201 200 201 277 112 112 112 112 112 112 112 112 112 112 112
112 112 112 112 112 112 112 112 112 112 112 112 112 112 112 112 116 111 110 111 110 111 110 117 112 112 112 112 112 112 112 112 112 112 112 112 112 112 112 112 112 112 112 112 112 112 112 112 112 112 112 276 201 200 201 200 201 200 277 112 112 112 112 112 112 112 112 112 112 112
112 112 112 112 112 112 112 112 112 112 112 112 112 112 112 112 118 119 119 119 119 119 119 120 112 112 112 112 112 112 112 112 112 112 112 112 112 112 112 112 112 112 112 112 112 112 112 112 112 112 112 118 119 119 100 100 119 119 120 112 112 112 112 112 112 112 112 112 112 112
112 112 112 112 112 112 112 112 112 112 112 112 112 112 112 112 112 112 112 112 112 112 112 112 112 112 112 112 112 112 112 112 112 112 112 100 100 112 112 112 112 112 112 112 112 112 112 112 112 112 112 112 112 112 100 100 112 112 112 112 112 112 112 112 112 112 112 112 112 112
112 112 112 112 112 112 112 112 112 112 112 112 112 112 112 112 112 112 112 112 112 112 112 112 112 112 112 112 112 112 112 112 112 112 112 112 100 100 100 100 100 100 100 100 100 112 112 112 112 112 112 112 112 112 100 100 112 112 112 112 112 112 112 112 112 112 112 112 112 112
112 112 112 112 112 112 112 112 112 112 112 112 112 112 112 112 112 112 112 112 112 112 112 112 112 112 112 112 112 112 112 112 112 112 112 112 112 112 112 112 112 112 112 112 100 112 112 112 112 112 112 112 112 112 100 100 112 112 112 112 112 112 112 112 112 112 112 112 112 112
112 112 112 112 112 112 112 112 112 112 112 112 112 112 112 112 112 112 112 112 112 112 112 112 112 112 112 112 112 112 112 112 112 112 112 112 112 112 112 112 112 112 112 112 100 100 100 100 100 100 100 100 100 100 100 100 112 112 112 112 112 112 112 112 112 112 112 112 112 112
112 112 112 112 112 112 112 112 112 301 302 302 321 322 323 302 302 302 302 302 302 303 302 302 351 352 353 302 302 304 302 302 302 302 302 302 302 302 302 302 306 112 112 112 100 100 100 100 100 100 100 100 100 100 100 100 112 112 112 112 112 112 112 112 112 112 112 112 112 112
112 112 112 112 112 112 112 112 112 307 310 308 324 339 326 308 308 308 308 310 308 307 328 308 354 355 356 308 328 309 308 308 308 308 308 308 308 308 308 308 309 112 112 112 100 112 112 112 112 112 112 112 112 112 112 112 112 112 112 112 112 112 112 112 112 112 112 112 112 112
112 112 112 112 112 112 112 112 112 311 330 336 337 339 336 337 337 337 338 330 338 313 342 342 342 342 342 342 342 371 342 342 342 342 342 342 342 342 342 342 372 112 112 112 100 112 112 112 112 112 112 112 112 112 112 112 112 112 112 112 112 112 112 112 112 112 112 112 112 112
112 112 112 112 112 112 112 112 112 312 335 335 331 339 331 331 331 331 331 331 331 313 342 342 342 342 342 342 342 374 302 302 302 302 302 302 302 305 342 391 306 112 112 112 100 112 112 112 403 404 404 404 404 404 404 404 404 404 404 404 405 112 112 112 112 112 112 112 112 112
112 112 112 112 112 112 112 112 112 312 331 335 331 339 331 331 331 331 335 331 331 313 342 342 361 362 363 342 342 375 308 308 308 308 308 308 308 324 342 326 309 112 112 112 100 112 112 112 406 400 401 402 400 401 402 400 401 402 400 401 407 112 112 112 112 112 112 112 112 112
112 112 112 112 112 112 112 112 112 312 331 331 341 341 341 341 341 341 331 331 331 313 342 342 364 365 366 342 342 342 342 342 342 342 342 342 342 342 342 342 371 112 112 112 100 112 112 112 406 401 402 400 401 402 400 401 402 400 401 402 407 112 112 112 112 112 112 112 112 112
112 112 112 112 112 112 112 112 112 312 331 331 341 341 341 341 341 341 331 335 331 313 342 342 367 368 369 342 342 376 302 302 305 342 391 302 306 342 342 342 371 112 112 112 100 112 112 112 406 402 400 401 402 400 401 402 400 401 402 400 407 112 112 112 112 112 112 112 112 112
112 112 112 112 112 112 112 112 112 312 331 331 341 341 341 341 341 341 327 327 331 314 342 342 342 342 342 342 342 371 308 308 308 342 392 308 309 342 342 342 371 112 112 112 100 112 112 112 406 400 401 402 400 401 402 400 401 402 400 401 407 112 112 112 112 112 112 112 112 112
112 112 112 112 112 112 112 112 112 312 331 331 336 337 337 337 337 338 331 327 331 315 342 342 342 342 342 342 342 372 342 342 342 342 342 342 371 342 342 342 371 112 112 112 100 112 112 112 406 401 402 400 401 402 400 401 402 400 401 402 407 112 112 112 112 112 112 112 112 112
112 112 112 112 112 112 112 112 112 312 331 331 332 331 331 331 331 331 331 327 332 336 337 339 337 337 337 337 337 377 342 342 342 342 342 342 371 342 342 342 371 112 112 112 100 112 112 112 406 402 400 401 402 400 401 402 400 401 402 400 407 112 112 112 112 112 112 112 112 112
112 112 112 112 112 112 112 112 112 312 332 331 331 331 331 331 331 332 331 327 327 327 327 327 331 331 331 332 331 378 342 342 342 342 342 342 371 342 342 342 372 112 112 112 100 112 112 112 406 400 401 402 400 401 402 400 401 402 400 401 407 112 112 112 112 112 112 112 112 112
112 112 112 112 112 112 112 112 112 300 302 302 302 302 302 302 302 302 302 302 305 301 302 302 302 302 302 302 302 393 391 302 302 302 302 302 394 321 322 323 396 112 112 112 100 112 112 112 406 401 402 400 401 402 400 401 402 400 401 402 407 112 112 112 112 112 112 112 112 112
112 112 112 112 112 112 112 112 112 307 328 308 328 308 328 308 346 345 346 308 328 307 308 308 308 308 308 308 308 308 308 308 308 308 308 308 395 324 342 326 395 112 112 112 100 112 403 404 420 402 400 401 402 400 401 402 400 401 413 409 410 112 112 112 112 112 112 112 112 112
112 112 112 112 112 112 112 112 112 316 343 343 343 343 343 343 347 347 347 343 343 311 310 336 337 337 337 337 337 337 337 337 337 337 337 337 337 338 339 336 338 112 112 112 100 112 406 401 402 400 401 402 400 401 402 400 401 402 416 112 112 112 112 112 112 112 112 112 112 112
112 112 112 112 112 112 112 112 112 316 343 343 343 343 343 343 343 343 343 343 343 312 332 332 332 331 331 331 331 331 332 331 331 331 331 332 332 331 339 331 378 112 112 112 100 112 406 402 400 401 402 400 401 402 400 401 402 400 416 112 112 112 112 112 112 112 112 112 112 112
112 112 112 112 112 112 112 112 112 316 343 343 343 343 343 343 345 346 345 343 343 316 344 344 344 344 344 344 344 344 344 344 344 344 344 344 344 344 343 344 320 112 112 112 100 112 406 400 401 402 400 401 402 400 401 402 400 401 416 112 112 112 112 112 112 112 112 112 112 112
112 112 112 112 112 112 112 112 112 316 343 343 343 343 343 343 347 347 347 343 343 317 343 343 343 343 343 343 343 343 343 343 343 343 343 343 343 343 343 343 319 112 112 112 100 112 406 401 402 400 401 402 400 401 402 400 401 402 416 112 112 112 112 112 112 112 112 112 112 112
112 112 112 112 112 112 112 112 112 316 343 343 343 343 343 343 343 343 343 343 343 318 343 343 343 343 343 343 343 343 343 343 343 343 343 343 343 343 343 343 319 112 112 112 100 112 406 402 400 401 402 400 401 402 400 401 402 400 416 112 112 112 112 112 112 112 112 112 112 112
112 112 112 112 112 112 112 112 112 316 343 343 343 343 343 343 343 343 343 343 343 343 343 343 343 343 343 343 343 343 343 343 343 343 343 343 343 343 343 343 319 112 112 112 100 112 406 400 401 402 400 401 402 400 401 402 400 401 416 112 112 112 112 112 112 112 112 112 112 112
112 112 112 112 112 112 112 112 112 397 302 302 302 305 339 339 391 302 302 302 302 302 302 302 302 302 302 302 302 302 302 302 302 302 302 302 302 302 302 302 396 112 112 112 100 112 406 401 402 400 401 402 400 401 402 400 401 402 416 112 112 112 112 112 112 112 112 112 112 112
112 112 112 112 112 112 112 112 112 392 308 308 308 395 339 339 392 308 308 308 308 308 308 308 308 308 308 308 308 308 308 308 308 308 308 308 308 308 308 308 395 112 112 112 100 112 406 402 400 401 402 400 401 402 400 401 402 400 416 112 112 112 112 112 112 112 112 112 112 112
112 112 112 112 112 112 112 112 112 112 112 112 112 112 100 100 112 112 112 112 112 112 112 112 112 112 112 112 112 112 112 112 112 112 112 112 112 112 112 112 112 112 112 112 100 112 406 400 401 402 400 401 402 400 401 402 400 401 416 112 112 112 112 112 112 112 112 112 112 112
112 112 112 112 112 112 112 112 112 112 112 112 112 112 100 100 100 100 100 100 100 100 100 100 100 100 100 100 100 100 100 100 100 100 100 100 100 100 100 100 100 100 100 100 100 112 408 409 409 409 409 409 409 409 409 409 409 409 410 112 112 112 112 112 112 112 112 112 112 112
112 112 112 112 112 112 112 112 112 112 112 112 112 112 112 112 112 112 112 112 112 112 112 112 112 112 112 112 112 112 112 112 112 112 112 112 112 112 112 112 112 112 112 112 112 112 112 112 112 112 112 112 112 112 112 112 112 112 112 112 112 112 112 112 112 112 112 112 112 112
112 112 112 112 112 112 112 112 112 112 112 112 112 112 112 112 112 112 112 112 112 112 112 112 112 112 112 112 112 112 112 112 112 112 112 112 112 112 112 112 112 112 112 112 112 112 112 112 112 112 112 112 112 112 112 112 112 112 112 112 112 112 112 112 112 112 112 112 112 112
112 112 112 112 112 112 112 112 112 112 112 112 112 112 112 112 112 112 112 112 112 112 112 112 112 112 112 112 112 112 112 112 112 112 112 112 112 112 112 112 112 112 112 112 112 112 112 112 112 112 112 112 112 112 112 112 112 112 112 112 112 112 112 112 112 112 112 112 112 112
112 112 112 112 112 112 112 112 112 112 112 112 112 112 112 112 112 112 112 112 112 112 112 112 112 112 112 112 112 112 112 112 112 112 112 112 112 112 112 112 112 112 112 112 112 112 112 112 112 112 112 112 112 112 112 112 112 112 112 112 112 112 112 112 112 112 112 112 112 112
112 112 112 112 112 112 112 112 112 112 112 112 112 112 112 112 112 112 112 112 112 112 112 112 112 112 112 112 112 112 112 112 112 112 112 112 112 112 112 112 112 112 112 112 112 112 112 112 112 112 112 112 112 112 112 112 112 112 112 112 112 112 112 112 112 112 112 112 112 112
112 112 112 112 112 112 112 112 112 112 112 112 112 112 112 112 112 112 112 112 112 112 112 112 112 112 112 112 112 112 112 112 112 112 112 112 112 112 112 112 112 112 112 112 112 112 112 112 112 112 112 112 112 112 112 112 112 112 112 112 112 112 112 112 112 112 112 112 112 112
112 112 112 112 112 112 112 112 112 112 112 112 112 112 112 112 112 112 112 112 112 112 112 112 112 112 112 112 112 112 112 112 112 112 112 112 112 112 112 112 112 112 112 112 112 112 112 112 112 112 112 112 112 112 112 112 112 112 112 112 112 112 112 112 112 112 112 112 112 112